########################################
######  ###########     #####    #######
#        ##########      ####     ######
#        ###########      ###     ######
#        ##########       ###     ######
#  ###  ##########         #        ####
######  ##########                   ###
######  ####    ##                    ##
######  ##                     S       #
#####                         ####     #
#####    ##E                 ######    #
######  ####                ########  ##
############    ####     ###############
###  ####       ####     ###############
##                      ################
##      ##             #################
##      ##          ########  ##########
###    ####  ##    ######      ####  ###
####  #########    ##                 ##
################  ##                   #
####################                   #
#####################    #        T    #
###########################      #     #
############################    ###   ##
########################################

