#####
#T E#
# # #
#S  #
#####
