#########
#      E#
#  #  # #
#  #T## #
#  ##   #
#S      #
#########