#########
#  T#  E#
#  0#   #
#S  #1  #
#########