#############
#  0  #  1  #
#S    #T    #
#  4  #######
#######  2  #
#  3   #    #
#     E#    #
#############