#############
#  0  #  1  #
#S    #T    #
#  2  #######
#######  3  #
#  4   #    #
#     E#    #
#############