#############
#0         3#
# T#### E#T #
#  #S ####  #
#1         2#
#############