############
#######S  ##
######   # #
#####   T# #
####0 #  ###
#    ####  #
#     E##  #
#         ##
# ##    ####
############

