########################################
##    #####  #  #  E  ###     ####   ###
##     ####  #  ###   ##  ##    #     ##
###    ######  # #    #T###    #   #  ##
##      #####   #    # # #  ## ### #####
###  # ######  # #  ##  #  ###  #  #####
##  # ########  #    ##  ######   ######
##   #########   ##      # ####    #####
#############    ##     #    ###   #   #
# ###########     ##   #  # # #  # #   #
#   ##########    ####### ## # ### #   #
#  # #########   ####### #    ###  ### #
###  #########     ####        ##   ## #
## # #########     ####       ####  ####
# #  #########  ##  #       ##  ##     #
#     #######    #       S##           #
#     #### ###             #           #
##    # #             #  ##  ##    #####
###        ##  #   # ## #  ###     #####
##        ##  # ### ##   # ###     ## ##
###        #  #    #      ########     #
####       #### # #        #######     #
######    ####  ##         ######      #
########    ##  ##    #   #######  #   #
########################################

